v<<<<<<<<<<<<<<<<<s<<<<<
vv<z<<<<<<<<<zz<<<s<<<<^
vv#D#########vv#SS###Dq^
vv###########vv#^^####^^
vv##########Dzv#^eD###^^
vv#D#########vv#^^####^^
vv<q<<<<s<<<<zv#^^####^^
vv<<<<<<s<<<<zv#^^####^^
vv####SS#####vv#^^####^^
vcD##Dq^####Dzv#^^####^^
vv####^^#####vv#^eD###^^
SS####^^#####vv#^^####^^
vvs<<<qq<<<<<zz<qq<<<<q^
vvs<<<<<<<<<zz<<<qq<<<q^
vv##########vv###^^###^^
vc>>>>>>>>>>cc>>>ee>>s^^
vc>>>>cc>>c>>cc>ee>>>s^^
vv####vv##D##vv#^^####SS
vv####vv#####vv#^^####^^
vv####vv#####vv#^^###Dq^
vv###Dzv####Dzv#^^####^^
vv####vv#####vv#^^####^^
vv####SS#####SS#^^#D##^^
v>>>>s>>>>>>s>>>ee>e>>^^
>>>>>s>>>>>>s>>>>>>>>>>^