v<<<<<<<<<<<<<<<<<s<<<<<
vv<<<<<<<<<<<zz<<<s<<<<^
vv#D#########vv#SS###D^^
vv###########vv#^^####^^
vv##########Dvv#^^D###^^
vv#D#########vv#^^####^^
vv<<<<<<s<<<<zv#^^####^^
vv<<<<<<s<<<<zv#^^####^^
vv####SS#####vv#^^####^^
vvD##D^^####Dvv#^^####^^
vv####^^#####vv#^^D###^^
SS####^^#####vv#^^####^^
vvs<<<qq<<<<<<<<qq<<<<q^
vvs<<<<<<<<<zz<<<<<<<<q^
vv##########vv###^^###^^
vc>>>>>>>>>>>>>>>ee>>s^^
vc>>>>cc>>>>>cc>>>>>>s^^
vv####vv##D##vv#^^####SS
vv####vv#####vv#^^####^^
vv####vv#####vv#^^###D^^
vv###Dvv####Dvv#^^####^^
vv####vv#####vv#^^####^^
vv####SS#####SS#^^#D##^^
v>>>>s>>>>>>s>>>ee>>>>^^
>>>>>s>>>>>>s>>>>>>>>>>^