vv<<<<<<<<<s<<<<<<<<<<<<
vz<<z<zz<<<s<z<zz<<<<<q<
vv##D#vv#SS##D#vv#####^^
vv####vv#^^####vv#####^^
vv####vv#^eD###vv####Dq^
vv#D##vv#^^####SS#####^^
vv<q<<zv#^^<<<<zzs<<<<q^
vv<<<<zv#^^<<<<zzs<<<<q^
vv####vv#^^####vv#####^^
vcD###vv#^^####vv####Dq^
vv###Dzv#^eD###vcD####^^
SS####vv#^^####vv#####^^
vvs<<<zz<qq<<<<<<<<<<<q^
vvs<<zz<<<qq<<<<<<<<<<q^
vv###vv###^^##########^^
vc>>>cc>>>ee>>>>>>>>>s^^
vc>>>>cc>ee>>>>cc>>c>s^^
vv####vv#^^####vv##D##SS
vcD###vv#^eD###vv<<<<<q^
vv####vv#^^####vv<<<<<q^
vv###Dzv#^^####vv#####^^
vv####vv#^^###Dzv####Dq^
vv####SS#^^####SS#####^^
>c>>>s>>>ee>>>s>>>>>>>e^
>>>>>s>>>>>>>>s>>>>>>>^^